{
	"cols": 15,
	"rows": 9,
	"map": 
	[
		0,0,0,0,0,0,0,0,0,0,0,0,0,0,0,
		0,0,0,0,0,0,0,0,0,0,0,0,0,0,0,
		0,0,0,1,1,0,0,1,0,0,1,1,0,0,0,
		0,0,1,1,0,0,0,1,0,0,0,1,1,0,0,
		0,0,1,0,0,0,1,1,1,0,0,0,1,0,0,
		0,0,1,1,0,0,0,1,0,0,0,1,1,0,0,
		0,0,0,1,1,0,0,1,0,0,1,1,0,0,0,
		6,6,6,1,0,0,0,1,0,0,0,1,6,6,6,
		6,6,1,6,6,6,6,1,6,6,6,6,1,6,6
	
	],
	
	"doorLeft": true,
	"doorRight":true, 
	"doorTop":true,
	"doorBottom":false
}