{
	"cols": 11,
	"rows": 13,
	"map": 
	[
		1,1,0,0,0,0,0,0,0,1,1,
		1,1,0,0,1,0,1,0,0,1,1,
		6,0,0,1,1,0,1,1,0,0,6,
		0,0,1,1,6,0,6,1,1,0,0,
		0,0,1,0,0,0,0,0,1,0,0,
		1,0,0,6,6,0,6,6,0,0,1,
		0,0,0,0,1,0,1,0,0,0,0,
		1,0,0,1,1,0,1,1,0,0,1,
		0,0,1,1,6,0,6,1,1,0,0,
		0,0,1,0,0,0,0,0,1,0,0,
		0,0,1,0,0,0,0,0,1,0,0,
		1,0,0,0,1,0,1,0,0,0,1,
		1,0,6,1,1,0,1,1,6,0,1
	],
	
	"doorLeft": true,
	"doorRight":true, 
	"doorTop":true,
	"doorBottom":true
}