{
	"cols": 15,
	"rows": 7,
	"map": 
	[	
		6,0,0,0,0,0,1,0,0,0,0,1,0,6,1,
		0,0,6,1,0,0,0,0,6,0,0,0,0,0,0,
		0,0,0,0,0,0,0,0,1,1,6,1,0,0,0,
		0,0,1,1,0,1,6,0,0,0,0,1,0,0,0,
		1,0,1,0,6,1,0,0,1,0,0,6,0,0,1,
		0,0,1,1,0,0,0,1,0,0,0,0,1,0,0,
		1,0,0,0,0,0,0,0,0,1,0,0,0,0,0
		
	],
	"doorLeft": true,
	"doorRight":true,
	"doorTop":true,
	"doorBottom":true
}