{
	"cols": 9,
	"rows": 7,
	"map": 
	[	
		1,0,0,0,0,0,1,0,0,
		0,0,0,0,0,0,0,0,0,
		0,0,1,0,0,0,0,0,0,
		0,0,1,6,6,1,1,0,0,
		0,0,0,0,0,1,0,0,0,
		0,0,0,0,0,0,0,0,0,
		16,0,1,0,0,0,0,0,1
		
	],
	"doorLeft": true,
	"doorRight":true,
	"doorTop":true,
	"doorBottom":true
}