{
	"cols": 17,
	"rows": 9,
	"map": 
	[	
		6,6,1,15,0,0,1,0,0,0,0,1,0,0,0,1,1,
		0,0,1,0,0,0,1,0,0,0,0,1,0,0,0,0,1,
		0,0,1,0,0,0,7,1,1,0,0,0,0,0,0,0,0,
		0,0,1,1,0,0,1,0,0,0,0,0,0,0,0,0,0,
		0,0,1,1,0,0,0,0,0,0,0,1,1,1,0,0,0,
		0,0,1,0,0,0,0,0,0,0,0,6,6,1,0,0,0,
		0,0,0,0,0,0,1,1,1,0,0,0,0,1,0,0,0,
		0,0,0,0,0,0,1,0,0,0,0,0,0,1,0,0,0,
		0,0,1,0,0,0,1,0,0,0,0,0,0,1,1,0,0
		
	],
	"doorLeft": true,
	"doorRight":true,
	"doorTop":true,
	"doorBottom":true
}