{
	"cols": 11,
	"rows": 9,
	"map": 
	[	
		15,1,0,0,0,0,0,0,0,1,15,
		1,0,0,0,0,0,0,0,0,6,1,
		0,0,0,6,1,1,1,0,0,0,0,
		0,0,6,1,1,1,1,1,0,0,0,
		0,0,1,1,1,1,1,1,1,0,0,
		0,0,0,1,1,1,1,1,6,0,0,
		0,0,0,6,1,1,1,6,0,0,0,
		1,0,0,0,0,0,0,0,0,0,1,
		15,1,0,0,0,0,0,0,0,1,15
		
	],
	"doorLeft": true,
	"doorRight":true,
	"doorTop":true,
	"doorBottom":true
}