{
	"cols": 13,
	"rows": 11,
	"map": 
	[	
		1,6,0,0,0,0,0,0,0,0,0,0,6,
		6,0,0,0,0,0,0,0,0,0,0,0,0,
		0,0,0,1,1,0,0,0,0,0,0,0,0,
		0,0,0,0,1,0,0,1,1,0,0,0,0,
		0,0,0,0,0,0,0,0,1,0,0,0,0,
		0,0,0,0,0,0,0,0,1,0,0,0,0,
		0,0,0,1,1,0,0,0,0,0,0,0,0,
		0,0,1,1,0,0,0,0,0,0,0,0,0,
		0,0,0,1,0,0,0,0,0,1,1,0,0,
		0,0,0,0,0,0,0,0,0,0,1,0,0,
		6,0,0,0,0,0,0,0,0,0,1,6,6
		
	],
	"doorLeft": true,
	"doorRight":true,
	"doorTop":true,
	"doorBottom":true
}