{
	"cols": 9,
	"rows": 15,
	"map": 
	[
		0,0,0,0,0,0,1,6,6,
		0,0,0,0,0,0,1,0,0,
		0,0,1,1,1,0,1,0,0,
		0,0,1,0,0,0,1,0,0,
		0,0,1,0,0,0,1,0,0,
		0,0,1,0,0,1,1,0,0,
		0,0,1,0,0,7,1,0,0,
		0,0,1,0,16,0,1,0,0,
		0,0,1,7,0,0,1,0,0,
		0,0,1,1,0,0,1,0,0,
		0,0,1,0,0,0,1,0,0,
		0,0,1,0,0,0,1,0,0,
		0,0,1,0,1,1,1,0,0,
		0,0,1,0,0,0,0,0,0,
		6,6,1,0,0,0,0,0,0

	 ],
	"doorLeft": true,
	"doorRight":true,
	"doorTop":true,
	"doorBottom":true
 }