{
	"cols": 9,
	"rows": 15,
	"map": 
	[
		7,7,1,0,0,0,1,0,0,
		0,0,1,0,0,0,0,0,0,
		0,0,0,1,0,0,0,0,0,
		0,0,0,0,1,1,0,0,0,
		1,0,0,0,0,1,0,0,0,
		1,1,0,0,0,1,0,0,0,
		0,0,1,0,0,1,0,0,0,
		0,0,1,0,0,0,0,0,0,
		0,0,0,1,0,0,0,0,0,
		0,0,0,0,0,0,0,1,1,
		0,0,0,0,0,0,0,0,0,
		0,0,0,0,1,0,0,0,0,
		0,0,0,0,0,1,0,0,0,
		1,6,0,0,0,0,1,0,0,
		1,1,0,0,0,0,1,7,7
	 ],
	"doorLeft": true,
	"doorRight":true,
	"doorTop":true,
	"doorBottom":true
 }