{
	"cols": 15,
	"rows": 9,
	"map": 
	[
		0,0,0,1,1,0,0,0,1,1,6,0,0,0,0,
		0,0,0,0,1,0,0,0,0,1,1,6,0,0,0,
		0,0,0,0,0,0,0,0,0,0,1,1,6,0,0,
		0,0,1,6,0,0,1,6,0,0,0,1,1,0,0,
		0,0,0,0,0,1,1,1,0,0,0,0,1,0,0,
		1,0,0,0,0,1,1,1,1,0,0,0,0,0,0,
		1,1,0,0,0,0,1,1,6,0,0,0,0,0,0,
		0,1,1,0,0,0,0,0,0,0,0,1,0,0,0,
		0,0,1,1,0,0,0,0,0,0,1,1,0,0,0
	
	 ],
	"doorLeft": true,
	"doorRight":false,
	"doorTop":false,
	"doorBottom":true
 }