{
	"cols": 15,
	"rows": 9,
	"map": 
	[
		6,0,0,0,0,0,0,0,1,0,6,1,1,6,6,
		1,1,0,0,1,0,0,0,0,0,0,1,1,0,0,
		1,1,0,0,1,1,1,1,0,0,0,0,0,0,0,
		0,0,0,0,1,6,0,1,0,0,0,0,0,0,0,
		0,0,0,0,0,0,0,0,0,0,0,1,1,1,1,
		0,0,1,0,0,0,0,0,0,0,0,0,0,0,0,
		0,1,1,0,0,1,1,1,1,0,0,0,1,0,0,
		0,0,0,0,0,1,6,6,6,0,0,0,1,0,0,
		0,0,0,0,6,1,1,1,1,1,0,0,1,6,6
	
	 ],
	"doorLeft": true,
	"doorRight":false,
	"doorTop":true,
	"doorBottom":false
 }