{
	"cols": 15,
	"rows": 9,
	"map": 
	[
		0,0,1,1,0,0,0,0,1,1,0,0,0,0,0,
		0,1,1,6,0,0,0,0,6,1,0,0,0,0,0,
		1,1,0,0,0,0,1,0,0,0,0,0,1,0,0,
		1,0,0,0,0,0,0,0,0,0,0,0,0,0,0,
		0,0,0,0,0,0,0,0,0,0,0,0,0,0,0,
		0,0,1,6,0,0,1,1,1,1,1,1,1,0,0,
		0,0,1,1,0,0,0,0,0,0,1,6,0,0,0,
		0,0,0,0,0,0,0,0,0,0,1,6,0,0,0,
		0,0,0,0,0,0,0,0,0,0,1,6,0,0,0
	 ],
	"doorLeft": false,
	"doorRight":true,
	"doorTop":false,
	"doorBottom":true
 }