{
	"cols": 15,
	"rows": 9,
	"map": 
	[
		1,1,0,0,0,1,0,0,0,1,0,0,0,1,1,
		0,1,1,0,0,0,0,0,0,0,0,0,1,1,0,
		0,0,1,1,0,0,0,0,0,0,0,1,1,0,0,
		0,0,1,1,0,0,0,6,0,0,0,1,1,0,0,
		0,0,0,0,0,0,0,6,0,0,0,0,0,0,0,
		0,0,1,1,0,0,0,0,0,0,0,1,1,0,0,
		0,0,1,1,0,0,0,5,0,0,0,1,1,0,0,
		0,1,1,0,0,0,0,0,0,0,0,0,1,1,0,
		1,1,0,0,0,1,0,0,0,1,0,0,0,1,1
	 ],
	"doorLeft": false,
	"doorRight":false,
	"doorTop":true,
	"doorBottom":true
 }